Bahnhof in Brüssel nach Bombendrohung geräumt
Steuermythos: Enteignet Mario Draghi die deutschen Sparer?
Krankmeldungen: TUIfly und Air Berlin streichen 56 Flüge
Sprechen mit dem Netz: Willkommen in der nächsten Digitalepoche
Großbritannien: Farage kehrt an Ukip-Spitze zurück
Vor Koalitionsgipfel: Einigung bei Lohngleichheit zeichnet sich ab
"Der König von St. Pauli": Schauspieler Hans Korte gestorben
Prügelattacke in Euskirchen: Zwölfjähriges Opfer auf dem Weg der Besserung
Analyse von Satellitenbildern: Angriff auf Hilfskonvoi in Syrien war Luftschlag
Zähne: Was tun, wenn es beim Zubeißen schmerzt?
Türkei: Abgeordnete in Incirlik - Besuchsverbot beendet
Buiräbähnli in der Schweiz: "Die Bahn ist unser Treppenhaus"
Mini-Zinsen: Deutscher Top-Banker warnt vor Finanzkollaps
Immobilien im Städtevergleich: Stuttgarter haben die größten Wohnungen
EU-Parlamentspräsident: Chaostage bei Suche nach Schulz-Nachfolger
YouTube: Jugendlicher kauft versehentlich Werbung für 100.000 Euro
Zerstörte Planschbecken: Poolschlitzer von Münnerstadt gefasst
Mode aus Müll: Trash chic
Steinwurf auf der A7: Mutter nach Unfall außer Lebensgefahr
Bitterfeld: 15-Jähriger in Innenstadt angeschossen
Chemie-Nobelpreis 2016: Ehrung für drei Molekülforscher
Lacher bei Brexit-Rede: "Breakfast, äh Brexit!"
Aquarium in Singapur: Stachelrochen tötet Taucher
Musikproduzent Craig Leon: "Ich wollte Patti Smith - und bekam die Ramones"
Populäre Historikerin: Brigitte Hamann ist tot
Auf Anweisung einer US-Behörde: Yahoo soll E-Mails aller Kunden durchsucht haben
Übertragungsrechte: ARD und ZDF zeigen EM 2020
R&B-Sängerin Banks: In der Gemütsgeisterbahn
Ex-Kanzlerkandidat der SPD: Peer Steinbrück wird Berater der ING-DiBa
Unesco: Weltweit 69 Millionen neue Lehrer gesucht
